[
  {
    "method": "json",
    "om_terrain": "dd_serfhouse_1",
    "//": "thatchroof variant 1",
    "type": "mapgen",
    "weight": 100,
    "object": {
      "fill_ter": "t_dirtfloor_thatchroof",
      "rows": [
        "........................",
        "........................",
        "........................",
        "........................",
        ".....###########........",
        ".....#         #........",
        ".....#         #........",
        ".....#         #........",
        ".....#{    #####.,......",
        ".....#          ,,,,....",
        ".....#####+#####,,.,,,,.",
        ".....#         #..,.,,,,",
        ".....#         #....,..,",
        ".....#    F    #........",
        ".....#         #........",
        ".....#B     bTb#........",
        ".....#B     bTb#........",
        ".....#         #........",
        ".....###########........",
        "........................",
        "........................",
        "........................",
        "........................",
        "........................"
      ],
      "palettes": [ "dd_serf_palette" ],
      "terrain": { "{": "t_ladder_up" },
      "furniture": { "F": "f_firering" }
    }
  },
  {
    "method": "json",
    "om_terrain": "dd_serfloft",
    "//": "variant 1",
    "type": "mapgen",
    "weight": 100,
    "object": {
      "fill_ter": "t_dirtfloor_thatchroof",
      "rows": [
        "........................",
        "........................",
        "........................",
        "........................",
        ".....###########........",
        ".....#o o    oo#........",
        ".....#o       o#........",
        ".....#         #........",
        ".....#{    #####........",
        ".....#~~~~~~~~~~........",
        ".....#~~~~~~~~~#........",
        ".....#~~~~~~~~~#........",
        ".....#~~~~~~~~~#........",
        ".....#~~~~~~~~~#........",
        ".....#~~~~~~~~~#........",
        ".....#~~~~~~~~~#........",
        ".....#~~~~~~~~~#........",
        ".....#~~~~~~~~~#........",
        ".....###########........",
        "........................",
        "........................",
        "........................",
        "........................",
        "........................"
      ],
      "palettes": [ "dd_serf_loft_palette" ],
      "terrain": { " ": "t_dirtfloor_thatchroof", "{": "t_ladder_down" },
      "furniture": { "o": "dd_f_barrel" }
    }
  },
  {
    "method": "json",
    "om_terrain": "dd_serfloft",
    "//": "variant 2",
    "type": "mapgen",
    "weight": 100,
    "object": {
      "fill_ter": "t_dirtfloor_thatchroof",
      "rows": [
        "........................",
        "........................",
        "........................",
        "........................",
        ".....###########........",
        ".....#         #........",
        ".....#         #........",
        ".....#         #........",
        ".....#{    #####........",
        ".....#~~~~~~~~~~........",
        ".....#~~~~~~~~~#........",
        ".....#~~~~~~~~~#........",
        ".....#~~~~~~~~~#........",
        ".....#~~~~~~~~~#........",
        ".....#~~~~~~~~~#........",
        ".....#~~~~~~~~~#........",
        ".....#~~~~~~~~~#........",
        ".....#~~~~~~~~~#........",
        ".....###########........",
        "........................",
        "........................",
        "........................",
        "........................",
        "........................"
      ],
      "palettes": [ "dd_serf_loft_palette" ],
      "terrain": { " ": "t_dirtfloor_thatchroof", "{": "t_ladder_down" }
    }
  }
]